111111111111111111
100000000000000001
100000000000000001
1P0000111CCCCCC1G1
1000001000000001E1
100000111000000101
111111111111111111