11111111
10000101
100P0111
1E000CC1
11111111