1111111111111111111111111111111111
1E000000000000C00000C0000000000001
1111010100100000101001000000010101
1010010010101010001001000000010101
10P000000C00C0000000000000000001C1
1111111111111111111111111111111111